red: 0,1,A,B
+++++++++++
+1   +Aa  +
+    +    + 
+    +    +
+    +    +
+    +    +
+    +    +
+    +    +
+    +    +
+    +    +
+    +    +
+    +    +
+    +    +
+    +    +
+  bB+0   +
+++++++++++
