+++++++++++++++
+  A  +++++  0+
+      abc    +
+  C  +++++B  +
+++++++++++++++